11111111
1P0000C1
111111C1
1E0000C1
11111111
