1111111111111111111
100000000C000000001
100000E00C000000001
100000000C000000001
100000000C000000001
1001111111111111001
100000000C000000001
100000000C000000001
100000000C00000P001
100000000C000000001
100000000C000000001
1111111111111111111
