1111111111111111111
110101CCCCCCC101011
110101CCCCCCE101011
110101CCCCCCC101011
110101PCCCCCC101011
1111111111111111111
1111111111111111111
