1111111111111111111
1P000000000000000C1
1111100111111000001
100C00001C000001111
1001111111111000001
1000C100C0000011E11
1111111111111111111
