111111111111111111111111111111
10000000C000000C00C0000000C001
111111110000011111110000111111
111111110P00011111110000111111
100111000000000000000000001111
111111111111000000000000000001
1111CC111100000001111111111001
1111CC1111000011110C0000C01001
111100011000000001111000111011
100000000C00000000000C00000001
1000C000000C000000C00000000001
1000000001111111111111C1010101
100111000111111111111110101011
1001E1000111111111111101010101
10000000000000000C000000C00001
111111111111111111111111111111
