1111111111111111111
1000000000000000101
11101P0000C00000101
100010000000C001101
10111000111100C0001
10001C0000E00110001
1111111111111111111
