111111
1P0Y01
1#0E01
1C00C1
111111
