11111
1C0C1
10001
10P01
11111
