1111111
1P00C01
1001
100C0E1
1111111
