111111111111
1000E0000C01
10000C000001
100000000001
10C0000C0001
111111111111
