 111111111
 100000001
 100000001
 100000001
111111111111
 81       |
 81  0  0 |
 81  -__- |
  81____ /
      |
   ___|_
  |▒▒▒|▒\
  \▒▒▒|▒ \___
   \▒▒|
    \▒|
     / \
    /   \
   /     \
  /       \
