1111111
1000001
10C0P01
10E0E01
1111111
