1111111
1000001
10P0P01
10C0E01
1111111
