11111
10P01
11111
1C0E1
11111
